00000000000000000000000000000000000000
00000000000000000000000000000000000000
00000000000000000000022220000000000000
00000022000000000000000000000000000000
00000000000000002222000000000000000000
00000000000000000000000000000000000000
00000000000000000000002222000000000000
02200000000000000000000000000000000000
00000000000000222222000000000000000000
00000222222200000000000000022000000000
00000000001122222222222222211002222000
00000000001111111111111111111001110000
00000000001111111111111111111000110000
00000000001111111111111111111000000000
00000000000000000000000000000000000000